....w.X.....
...XXXX..w..
.........X..
...H.....X..
.........w..
XXX...X.....
.w.......X..
.........X..
...X........
..X.....w...
w.X..XX.XX..
..X.....w...
